p02
  ######
  #    #
  #    #
#####  #
#   #.#####
#   $@$   #
#####.#   #
   ## ## ##
   #   $.#
   #   ###
   #####