p07
 ######
##    #
#   $ #
#  $$ #
### .#####
  ##.# @ #
   #.  $ #
   #. ####
   ####