p10
########
#@     #
# .$$. #
# $..$ #
# $..$ #
# .$$. #
#      #
########