p11
  ####
  #  #
  #  ####
###$.$  #
#  .@.  #
#  $.$###
####  #
   #  #
   ####