p13
#####
#   #
# . #
#.@.###
##.#  #
#  $  #
# $   #
##$$  #
 #  ###
 #  #
 ####