p17
######
#    ##
# $ $ ##
## $$  #
 # #   #
 # ## ##
 #  . .#
 # @. .#
 #  ####
 ####