p19
 #####
##   ##
#  $  ##
# $ $  ##
###$# . ##
  # # .  #
 ## ##.  #
 # @  . ##
 #   #  #
 ########