p20
 ####
##  #
#. $#
#.$ #
#.$ #
#.$ #
#. $##
#   @#
##   #
 #####