microban112
 #####
##   ####
#  $$$  #
# #   $ #
#   $## ##
###  #.  #
  #  #   #
 ##### ###
 #   # ##
 # @....#
 #      #
 #   #  #
 ########
