microban49
######
# @  #
# $# #
# $  #
# $ ##
### ####
 #  #  #
 #...  #
 #     #
 #######
