microban78
 #######
##     ##
#  $ $  #
# $ $ $ #
## ### ####
 #@  .....#
 ##     ###
  #######
