microban122
#####
#   ###
# #$  #
# $   #
# $ $ #
# $#  #
#  @###
## ########
#      ...#
#         #
########..#
       ####
