microban106
 ########
 #      #
 #@   $ #
## ###$ #
# .....###
# $ $ $  #
###### # #
     #   #
     #####
