microban10
      #####
      #.  #
      #.# #
#######.# #
# @ $ $ $ #
# # # # ###
#       #
#########
