microban94
#########
# @ #   #
# $ $   #
##$### ##
#  ...  #
#   #   #
######  #
     ####
