microban59
############
#          #
# ####### @##
# #         #
# #  $   #  #
# $$ #####  #
###  # # ...#
  #### #    #
       ######
