microban126
 ###########
##.......  #
# $$$$$$$@ #
#   # # # ##
# # #     #
#   #######
#####
