microban73
####
#  #####
# $$ $ #
#      #
## ## ##
#...#@#
# ### ##
#      #
#  #   #
########
