microban92
  ####
  #  #    #####
  #  #    #   #
  #  ######.# #
####  $    .  #
#   $$# ###.# #
#   #   # #   #
######### #@ ##
          #  #
          ####
