microban18
#######
#     #
#. .  #
# ## ##
#  $ #
###$ #
  #@ #
  #  #
  ####
