microban67
#####
#   ##
# #  #
#@$*.##
##  . #
 # $# #
 ##   #
  #####
