microban100
#######
# @#  #
#.$   #
#. # $##
#.$#   #
#. # $ #
#  #   #
########
